                 NO         ./textures/test.xpm





            SO                   ./textures/test.xpm






              WE                 ./textures/test.xpm




                EA               ./textures/test.xpm
F 220,25,34

C 225,220,01


111111
100001
100001
1000N1
111111
