                 NO ./textures/northwall.xpm





            SO  textures/southwall.xpm






              WE                 ./textures/westwall.xpm

                        EA               ./textures/eastwall.xpm

F 195,149,90

C 43,241,247

11111111111 1111111111111111
10000000001 10000000000001
1011000001111000000000001
1001000000000000000100001
1111111111011000001110001
10000000001100000111011111111
11110111111111011100000010001
1111011111111100001010010001
110000000101010000000010011
10000000000000000000000010111111111111111111111111111111111111
110000000000000001010010011
  11000011110010111101111001111
1100000001 1110101 101111010001
1N00001111 1111111 111111111111
11111111111111111111111111111





