                 NO ./textures/northwall.xpm





            SO  textures/southwall.xpm






              WE                 ./textures/westwall.xpm

                        EA               ./textures/eastwall.xpm

F 0,0,255

C 225,220,21
11111111111111111111111111111111111111111111111111111
1000000000110000000000001
1011000001110000000000001
1001000000000000000100001
1111111111011000001110001
10000000001100000111011111111
11110111111111011100000010001
11110111111111011001010010001
11000000N10101011100000010001
10000000000000001100000010001
10000000000000001101010010001
11000001110010111101111000111
11110111 1110101 101111010001
11111111 1111111 111111111111
11111111 1111111 111111111111
11111111 1111111 111111111111
11111111 1111111 111111111111
11111111 1111111 111111111111
11111111 1111111 111111111111
11111111 1111111 111111111111
11111111 1111111 111111111111
11111111 1111111 111111111111
11111111 1111111 111111111111
11111111 1111111 111111111111
11111111 1111111 111111111111
11111111 1111111 111111111111
11111111 1111111 111111111111